DexelsVersionControl -> com.dexels.navajo.version
NavajoDocument -> com.dexels.navajo.document
NavajoClient -> com.dexels.navajo.client
com.dexels.navajo.core.feature -> com.dexels.navajo.core.feature
Navajo -> com.dexels.navajo.core
NavajoAsyncClient -> com.dexels.navajo.client.async
NavajoFunctions -> com.dexels.navajo.function
com.dexels.navajo.authentication.api -> com.dexels.navajo.authentication.api
NavajoBIRT -> com.dexels.navajo.birt.push
NavajoJspServer -> com.dexels.navajo.jsp.server
NavajoJsp -> com.dexels.navajo.jsp
com.dexels.navajo.tipi.swt.client -> com.dexels.navajo.tipi.swt.client
com.dexels.navajo.dev -> com.dexels.navajo.dev.feature
NavajoScriptPlugin -> com.dexels.navajo.dev.script
com.dexels.navajo.server.embedded -> com.dexels.navajo.server.embedded
com.dexels.navajo.dsl.navajomanager -> com.dexels.navajo.dsl.navajomanager
com.dexels.navajo.dsl.expression -> com.dexels.navajo.dsl.expression
com.dexels.navajo.dsl.expression.model -> com.dexels.navajo.dsl.expression.model
com.dexels.navajo.dsl.expression.ui -> com.dexels.navajo.dsl.expression.ui
com.dexels.navajo.dsl.tsl -> com.dexels.navajo.dsl.tsl
com.dexels.navajo.dsl.tsl.model -> com.dexels.navajo.dsl.tsl.model
com.dexels.navajo.dsl.tsl.ui -> com.dexels.navajo.dsl.tsl.ui
com.dexels.navajo.dsl.dev.integration -> com.dexels.navajo.dsl.integration
com.dexels.navajo.language.feature -> com.dexels.navajo.dsl.feature
NavajoRemoteTestLibrary -> com.dexels.navajo.remotetest
NavaDoc -> com.dexels.navajo.dev.navadoc
NavaTest -> com.dexels.navajo.dev.navajo.test
com.dexels.navajo.tools.wsdl -> com.dexels.navajo.wsdl
com.dexels.navajo.wsdl.feature -> com.dexels.navajo.wsdl.feature
com.dexels.navajo.server.enterprise.feature -> com.dexels.navajo.enterprise.feature
NavajoEnterpriseListeners -> com.dexels.navajo.enterprise.listeners
NavajoEnterpriseAdapters -> com.dexels.navajo.enterprise.adapters
NavajoEnterprise -> com.dexels.navajo.enterprise
com.dexels.navajo.enterprise.listeners.deps -> com.dexels.navajo.enterprise.listeners.deps
com.dexels.navajo.enterprise.adapters.deps -> com.dexels.navajo.enterprise.adapters.deps
com.dexels.navajo.mongo.feature -> com.dexels.navajo.mongo.feature
com.dexels.navajo.mongo -> com.dexels.navajo.mongo
com.dexels.navajo.mongo.navajostore -> com.dexels.navajo.mongo.navajostore
com.dexels.navajo.other.feature -> com.dexels.navajo.other.feature
com.dexels.navajo.resource.feature -> com.dexels.navajo.resource.feature
com.dexels.navajo.resource -> com.dexels.navajo.resource
com.dexels.navajo.resource.jdbc.h2 -> com.dexels.navajo.resource.jdbc.h2
com.dexels.navajo.resource.jdbc.mysql -> com.dexels.navajo.resource.jdbc.mysql
com.dexels.navajo.resource.jdbc.oracle -> com.dexels.navajo.resource.jdbc.oracle
com.dexels.navajo.resource.mongodb -> com.dexels.navajo.resource.mongodb
com.dexels.navajo.resource.test -> com.dexels.navajo.resource.test
com.dexels.navajo.resource.manager -> com.dexels.navajo.resource.manager
com.dexels.navajo.test.feature -> com.dexels.navajo.test.feature
NavajoRemoteTestLibrary -> com.dexels.navajo.test.remote
NavajoServer -> com.dexels.navajo.server
com.dexels.navajo.server.bridged -> com.dexels.navajo.server.bridged
com.dexels.navajo.server.bridged.deploy -> com.dexels.navajo.server.bridged.deploy
NavajoIdeal -> com.dexels.navajo.enterprise.ideal
sportlink-ideal -> com.dexels.navajo.enterprise.ideal.sportlink
OpenfireNavajo -> com.dexels.navajo.enterprise.openfire
NavajoTomahawk -> com.dexels.navajo.enterprise.tomahawk
NavajoUtilities -> com.dexels.navajo.utilities
com.dexels.navajo.birt.oda.feature -> com.dexels.navajo.oda.feature
com.dexels.navajo.oda -> com.dexels.navajo.oda
com.dexels.navajo.oda.ui -> com.dexels.navajo.oda.ui
ImageProvider -> com.dexels.geospatial.imageprovider
RDFBrowser -> com.dexels.demos.rdfbrowser
Ticketing -> com.dexels.demos.ticketing
PeelPage -> com.dexels.demos.peelpage
PinkRoccadeAdapters -> com.dexels.demos.pinkroccade.adapters
PinkRoccadeEI -> com.dexels.demos.pinkroccade.ei
PeelPage -> com.dexels.utilities.smsgateway
StadiumDesigner -> com.dexels.demos.stadiumdesigner
TipiDashboard -> com.dexels.demos.tipidashboard
Dexels -> com.dexels.documents
Papers -> com.dexels.papers
DexelsDocs -> com.dexels.documents.other
KNVBTicketing -> com.dexels.documents.ticketing
KNHB-Sporttaal -> com.sportlink.knhb.sporttaal
KNZB-JSP-Interface -> com.sportlink.knzb.interface
MDex -> com.sportlink.james
NavajoCocoaClient -> com.dexels.navajo.cocoa.client
SportlinkDwfTouch -> com.sportlink.dwf.bv.ios
KNVBWidget -> com.sportlink.knvb.widget
NavajoPhp -> com.dexels.navajo.client.php
NavajoPhpLibrary -> com.dexels.navajo.client.php.library
NavajoJoomlaPlugin -> com.dexels.navajo.php.joomla
DexDMS -> com.sportlink.dms.joomla
sportlink-dwf-bv -> com.sportlink.dwf.bv.web
AutomatischePouleIndeling -> com.sportlink.optimizepool
DocumentManagement -> com.sportlink.dms.client
GeoJsp -> com.sportlink.geo.jsp
Geo -> com.sportlink.geo
sportlink-downloadcentre -> com.sportlink.downloadservlet
sportlink-knvb-digitaalinschrijven -> com.sportlink.digitaalinschrijven
AccommodatieZaken -> com.sportlink.accommodatiezaken
SportlinkClub -> com.sportlink.club
TensingOracle -> com.sportlink.tensing
SportlinkOfficialPortal -> com.sportlink.officialportal
NavajoSwingClient -> com.sportlink.swing.client
sportlink-serv -> com.sportlink.serv
TipiFacilityOccpation -> com.sportlink.tipi.facilityoccupation
sportlink-clnt-v2 -> com.sportlink.client
sportlink-adapters -> com.sportlink.adapters
sportlink-serv-crystal -> com.sportlink.crystal
sportlink-serv-AAA -> com.sportlink.aaa
sportlink-serv-comp -> com.sportlink.comp
SportlinkMatchForms -> com.sportlink.matchforms
SportlinkBackoffice -> com.sportlink.backoffice
GoogleEarthAccommodations -> com.sportlink.accommodations
SportlinkCIF -> com.sportlink.cif
NevoboDPS -> com.sportlink.nevobo.dps
SportlinkDWF -> com.sportlink.dwf.av
DWFDashboard -> com.sportlink.dwf.dashboard
SportlinkDashboard -> com.sportlink.dashboard
SportlinkReports -> com.sportlink.reports
SportlinkTeamRegistration -> com.sportlink.teamregistration
SportlinkWebshop -> com.sportlink.webshop
sportlink-dba -> com.sportlink.dba
sportlink-analysis -> com.sportlink.analysis
TipiLessonOne -> tipi.lesson.one
TipiLessonTwo -> tipi.lesson.two
TipiLessonThree -> tipi.lesson.three
TipiLessonFour -> tipi.lesson.four
TipiLessonFive -> tipi.lesson.five
TipiLessonSix -> tipi.lesson.six
TwitterAdapter -> com.dexels.navajo.twitter
com.dexels.navajo.twitter.feature -> com.dexels.navajo.twitter.feature
NavajoSvgRenderAdapter -> com.dexels.navajo.svg
NavajoGeoTools -> com.dexels.navajo.geo
NavajoKmlAdapter -> com.dexels.navajo.kml
com.dexels.navajo.geo.feature -> com.dexels.navajo.geo.feature
com.dexels.navajo.workflow.editor -> com.dexels.navajo.workflow.editor
com.dexels.navajo.workflow.editor.gmf -> com.dexels.navajo.workflow.editor.gmf
com.dexels.navajo.editor.feature -> com.dexels.navajo.workflow.editor.feature
NavajoPDF -> com.dexels.navajo.function.pdf
FileUploadServlet -> com.dexels.navajo.fileuploadservlet
com.dexels.navajo.server.feature -> com.dexels.navajo.server.feature
com.dexels.navajo.server.embedded.feature -> com.dexels.navajo.server.embedded.feature
NavajoQueueManager -> com.dexels.navajo.queuemanager
NavajoListeners -> com.dexels.navajo.listeners
NavajoListenersContinuations -> com.dexels.navajo.listeners.continuations
NavajoAdapters -> com.dexels.navajo.adapters
NavajoRhino -> com.dexels.navajo.rhino
com.dexels.navajo.authentication.api -> com.dexels.navajo.authentication.api
NavajoServer -> com.dexels.navajo.server.deploy
NavajoAgents -> com.dexels.navajo.agents
NavajoDBReplicationService -> com.dexels.navajo.enterprise.dbreplication
NavajoJspDeploy -> com.dexels.navajo.jsp.deploy
NavajoDashboardTwo -> com.dexels.navajo.dashboard
com.dexels.target -> com.dexels.target
com.dexels.repository -> com.dexels.repository
com.dexels.navajo.tipi.swing.docking.feature -> com.dexels.navajo.tipi.swing.docking.feature
TipiSwingDocking -> com.dexels.navajo.tipi.swing.docking
com.dexels.navajo.tipi.swing.charting.feature -> com.dexels.navajo.tipi.swing.charting.feature
TipiCharting -> com.dexels.navajo.tipi.swing.charting
com.dexels.navajo.tipi.swing.editor.feature -> com.dexels.navajo.tipi.swing.editor.feature
TipiSwingEditor -> com.dexels.navajo.tipi.swing.editor
NavajoSwingEditor -> com.dexels.navajo.swing.editor
com.dexels.navajo.tipi.swing.svg.feature -> com.dexels.navajo.tipi.swing.svg.feature
TipiSvgBatik -> com.dexels.navajo.tipi.swing.svg
com.dexels.navajo.tipi.swing.mig.feature -> com.dexels.navajo.tipi.swing.mig.feature
TipiSwingMig -> com.dexels.navajo.tipi.swing.mig
com.dexels.navajo.tipi.swing.substance.feature -> com.dexels.navajo.tipi.swing.substance.feature
TipiSubstance -> com.dexels.navajo.tipi.swing.substance
com.dexels.navajo.tipi.swing.geo.feature -> com.dexels.navajo.tipi.swing.geo.feature
TipiSwingX -> com.dexels.navajo.tipi.swing.swingx
TipiGeoSwing -> com.dexels.navajo.tipi.swing.geo
TipiJxLayer -> com.dexels.navajo.tipi.swing.jxlayer
com.dexels.navajo.tipi.swing.rich.feature -> com.dexels.navajo.tipi.swing.rich.feature
NavajoRichClient -> com.dexels.navajo.tipi.swing.rich.client
NavajoRichTipi -> com.dexels.navajo.tipi.swing.rich
com.dexels.navajo.tipi.swing.cobra.feature -> com.dexels.navajo.tipi.swing.cobra.feature
TipiCobraBrowser -> com.dexels.navajo.tipi.swing.cobra
com.dexels.navajo.tipi.flickr.feature -> com.dexels.navajo.tipi.flickr.feature
TipiFlickr -> com.dexels.navajo.tipi.flickr
com.dexels.navajo.tipi.mail.feature -> com.dexels.navajo.tipi.mail.feature
TipiMail -> com.dexels.navajo.tipi.mail
com.dexels.navajo.tipi.jabber.feature -> com.dexels.navajo.tipi.jabber.feature
TipiJabber -> com.dexels.navajo.tipi.jabber
com.dexels.navajo.tipi.ruby.feature -> com.dexels.navajo.tipi.ruby.feature
TipiRuby -> com.dexels.navajo.tipi.ruby
com.dexels.navajo.tipi.rss.feature -> com.dexels.navajo.tipi.rss.feature
TipiRss -> com.dexels.navajo.tipi.rss
NavajoReportingTipi -> com.dexels.navajo.tipi.reporting
TipiRDF -> com.dexels.tipi.swing.rdf
StadiumDesignTipi -> com.dexels.tipi.swing.stadiumdesign
Tipi3d -> com.dexels.tipi.swing.3d
TipiMonkey -> com.dexels.tipi.swing.monkeyengine
com.dexels.navajo.tipi.rcp -> com.dexels.navajo.tipi.rcp
NavajoTipi -> com.dexels.navajo.tipi
com.dexels.navajo.tipi.feature -> com.dexels.navajo.tipi.feature
com.dexels.navajo.tipi.swing.feature -> com.dexels.navajo.tipi.swing.feature
TipiSwingClient -> com.dexels.navajo.tipi.swing.client
NavajoSwingTipi -> com.dexels.navajo.tipi.swing
com.dexels.navajo.tipi.swing.deps -> com.dexels.navajo.tipi.swing.deps
com.dexels.navajo.tipi.swing.application -> com.dexels.navajo.tipi.swing.application
NavajoEchoTipi -> com.dexels.navajo.tipi.echo
NavajoEchoClient -> com.dexels.navajo.tipi.echo.client
com.dexels.navajo.tipi.echo.feature -> com.dexels.navajo.tipi.echo.feature
com.dexels.navajo.tipi.vaadin -> com.dexels.navajo.tipi.vaadin
com.dexels.navajo.tipi.vaadin.bridged -> com.dexels.navajo.tipi.vaadin.bridged
com.dexels.navajo.tipi.vaadin.embedded -> com.dexels.navajo.tipi.vaadin.embedded
com.dexels.navajo.tipi.vaadin.bridged.deploy -> com.dexels.navajo.tipi.vaadin.bridged.deploy
com.dexels.navajo.tipi.vaadin.feature -> com.dexels.navajo.tipi.vaadin.feature
TipiBuildLibrary -> com.dexels.navajo.tipi.dev.core
TipiAntBuild -> com.dexels.navajo.tipi.dev.ant
TipiPlugin -> com.dexels.navajo.tipi.dev.plugin
com.dexels.navajo.tipi.dev.feature -> com.dexels.navajo.tipi.dev.feature
TipiBuild -> com.dexels.navajo.tipi.build
TipiServer -> com.dexels.navajo.tipi.server
